##################
#                #
#   %            #
#                #
#                #
#                #
#                #
#                #
#                #
#                #
#                #
#                #
#       &        #
########_ ########
