##################
#               )/
#                 
#                #
|(               #
                 #
#                #
#                #
#                #
#                #
#                #
#                #
#                #
##################
