##################
|(               #
                 #
#                #
#                #
#               )0
#                 
#                #
#                #
#                #
#                #
#                #
#       &        #
########_ ########
