########- ########
#       %        #
#               )/
#                 
#    *           #
#               =#
|(      $        #
                 #
#                #
#            @   #
#     1          #
#                #
#             &  #
##############_ ## 
