########- ########
#       %        #
#                #
#                #
#                #
#                #
#                #
#                #
#                #
#                #
|(               #
                 #
# &              #
##_ ##############
