##############- ##
#             %  #
#                #
#   3            #
#                #
#                #
O(               #
                 #
#                #
#                #
#                #
#                #
#       &        #
########_ ########
