##############- ##
#             %  #
#                #
#                #
#                #
#                #
#                #
#                #
#                #
#                #
#                #
#               )/
#   &             
####_ ############
