########- ########
#       %        #
#                #
#                #
#                #
#                #
#                #
#                #
#                #
#                #
#                #
|(               #
 &               #
#_ ###############
