##################
#                #
#                #
#                #
#                #
#                #
#               ) 
#                 
#                #
#                #
#                #
#                #
#                #
#########  #######
