##################
#                #
#                #
###        @     #
#                #
#                #
#   @            #
#                #
#                #
#   $         @  #
#       @        #
# @          #####
#                #
##################
