##################
#                #
#                #
#                #
#                #
#                #
#                #
#                #
#                #
#                #
#                #
#             &  #
#                #
####x ############
