##################
#                #
#                #
#                #
#                #
#                #
#                #
#                #
#                #
#                #
#                #
#                #
#       &        #
########  ########
