##  ##############
#                #
#                #
#                #
#               ) 
#                 
#                #
#                #
#                #
#                #
#                #
#                #
#       &        #
########  ########
