##X ##############
#                #
#                #
#                #
#               )/
#                 
#                #
#                #
#                #
#                #
#                #
#                #
#       &        #
########_ ########
