##################
#               ) 
#                 
#                #
 (               #
                 #
#                #
#                #
#                #
#                #
#                #
#                #
#                #
##################
