##################
                 #
                 #
#                #
#                #
#                !
#                !
#                #
#                #
#                #
#                #
#                #
#                #
########  ########
