##################
 (               #
                 #
#                #
#                #
#               )!
#                !
#                #
#                #
#                #
#                #
#                #
#       &        #
########  ########
