##################
#                #
#       %        #
#                #
#           :    #
#                #
#    ~          )/
#                 
#                #
#     ;          #
#                #
#                #
#             &  #
##############_ ##
