##################
#                #
#                #
#                #
#                #
#                #
#               ) 
#                 
#                #
#                #
#                #
#                #
#             &  #
##############  ##
