##################
#                #
#       %        #
#   ^            #
#           :    #
#                #
#    ~          )/
#          ?      
#                #
#     ;          #
#                #
#                #
#             &  #
##############_ ##
