##################
#                #
#       %        #
#                #
#                #
#                #
#               )/
#                 
#                #
#                #
#                #
#                #
#             &  #
##############_ ##
