########- ########
#       %        #
#               )\
#                 
#                #
#                #
|(      $        #
                 #
#                #
#                #
#                #
#                #
#             &  #
##############_ ## 
