########  ########
#                #
#                 
#                 
#                #
#                #
                 #
                 #
#                #
#                #
#                #
#                #
#                #
##############  ## 
