##################
#                #
|(               #
                 #
#                #
#                #
#                #
#                #
#                #
#                #
#               )/
#                 
#       &        #
########_ ########
