##################
#                #
 (               #
                 #
#                #
#                #
#                #
#                #
#                #
#                #
#               ) 
#                 
#       &        #
########  ########
