########  ########
#       %        #
#                #
#                #
#                #
#                #
#                #
#                #
#                #
#                #
 (               #
                 #
# &              #
##  ##############
