##############  ##
#             %  #
#                #
#                #
#                #
#                #
!(               #
!                #
#                #
#                #
#                #
#                #
#       &        #
########  ########
