##############  ##
#                #
#                #
#                #
#                #
#                #
!                #
!                #
#                #
#                #
#                #
#                #
#                #
########  ########
