##############  ##
#             %  #
#                #
#                #
#                #
#                #
#                #
#                #
#                #
#                #
#                #
#               ) 
#   &             
####  ############
