##############  ##
#                #
#                #
#                #
#                #
#                #
#                #
#                #
#                #
#                #
#                #
#                 
#                 
####  ############
