########  ########
#       %        #
#                #
#                #
#                #
#                #
#                #
#                #
#                #
#                #
#                #
 (               #
 &               #
#  ###############
