########  ########
#                #
#                #
#                #
#                #
#                #
#                #
#                #
#                #
#                #
#                #
                 #
                 #
#  ###############
