##  ##############
# %              #
#                #
#                #
#                #
#                #
#                #
#                #
#                #
#                #
#                #
#                #
#                #
##################
