##  ##############
#                #
#                #
#                #
#                #
#                #
#                #
#                #
#                #
#                #
#                #
#                #
#                #
##################
