########  ########
#       %        #
#                #
#                #
#               ) 
#                 
#                #
#                #
#                #
#                #
#                #
#                #
#                #
##################
