#- ###############
#%               #
#                #
#                #
#                #
#                #
#               )/
#                 
#                #
#                #
#                #
#                #
#                #
##################
