#  ###############
#%               #
#                #
#                #
#                #
#                #
#               ) 
#                 
#                #
#                #
#                #
#                #
#                #
##################
