####- ############
#   %            #
#                #
#                #
#                #
#                #
# (              #
#                #
#                #
#                #
#                #
#                #
#                #
##################
