##################
#                #
#                #
#                #
#                #
#                #
#                 
#                 
#                #
#                #
#                #
#                #
#        !!      #
##################
