##################
#                #
#                #
#                #
#                #
#                #
 (              ) 
                  
#                #
#                #
#                #
#                #
#             &  #
##############  ##
