##################
#                #
#                #
#                #
#                #
#                #
                  
                  
#                #
#                #
#                #
#                #
#                #
##############  ##
